8,8,8,8,8,8,8,8,8,8,8,8,8,8,8,8,8,8,8,8,8,8,8,8,8,8,8,8,8,8,8,8,8,8,8,8,8,8,8,8,8,8,8,8,8,8,8,8,8,8,8,8,8,8,8,8,8,8,8,8,8,8,8,8,8,8,8,8,8,8,8,8,8,8,8,8,8,8,8,8
8,1,0,1,0,1,0,1,0,1,6,1,0,1,0,1,0,1,0,1,6,1,0,1,0,1,0,1,0,1,6,1,0,1,0,1,0,1,0,1,6,1,0,1,0,1,0,1,0,1,6,1,0,1,0,1,0,1,0,1,6,1,0,1,0,1,0,1,0,1,6,1,0,1,0,1,0,1,0,8
8,0,1,0,1,0,1,0,1,0,6,0,1,0,1,0,1,0,1,0,6,0,1,0,1,0,1,0,1,0,6,0,1,0,1,0,1,0,1,0,6,0,1,0,1,0,1,0,1,0,6,0,1,0,1,0,1,0,1,0,6,0,1,0,1,0,1,0,1,0,6,0,1,0,1,0,1,0,1,8
8,1,0,1,0,1,0,1,0,1,6,1,0,1,0,1,0,1,0,1,6,1,0,1,0,1,0,1,0,1,6,1,0,1,0,1,0,1,0,1,6,1,0,1,0,1,0,1,0,1,6,1,0,1,0,1,0,1,0,1,6,1,0,1,0,1,0,1,0,1,6,1,0,1,0,1,0,1,0,8
8,0,1,0,1,0,1,0,1,0,6,0,1,0,1,0,1,0,1,0,6,0,1,0,1,0,1,0,1,0,6,0,1,0,1,0,1,0,1,0,6,0,1,0,1,0,1,0,1,0,6,0,1,0,1,0,1,0,1,0,6,0,1,0,1,0,1,0,1,0,6,0,1,0,1,0,1,0,1,8
8,1,0,1,0,1,0,1,0,1,6,1,0,1,0,1,0,1,0,1,6,1,0,1,0,1,0,1,0,1,6,1,0,1,0,1,0,1,0,1,6,1,0,1,0,1,0,1,0,1,6,1,0,1,0,1,0,1,0,1,6,1,0,1,0,1,0,1,0,1,6,1,0,1,0,1,0,1,0,8
8,0,1,0,1,0,1,0,1,0,6,0,1,0,1,0,1,0,1,0,6,0,1,0,1,0,1,0,1,0,6,0,1,0,1,0,1,0,1,0,6,0,1,0,1,0,1,0,1,0,6,0,1,0,1,0,1,0,1,0,6,0,1,0,1,0,1,0,1,0,6,0,1,0,1,0,1,0,1,8
8,1,0,1,0,1,0,1,0,1,6,1,0,1,0,1,0,1,0,1,6,1,0,1,0,1,0,1,0,1,6,1,0,1,0,1,0,1,0,1,6,1,0,1,0,1,0,1,0,1,6,1,0,1,0,1,0,1,0,1,6,1,0,1,0,1,0,1,0,1,6,1,0,1,0,1,0,1,0,8
8,0,1,0,1,0,1,0,1,0,6,0,1,0,1,0,1,0,1,0,6,0,1,0,1,0,1,0,1,0,6,0,1,0,1,0,1,0,1,0,6,0,1,0,1,0,1,0,1,0,6,0,1,0,1,0,1,0,1,0,6,0,1,0,1,0,1,0,1,0,6,0,1,0,1,0,1,0,1,8
8,1,0,1,0,1,0,1,0,1,6,1,0,1,0,1,0,1,0,1,6,1,0,1,0,1,0,1,0,1,6,1,0,1,0,1,0,1,0,1,6,1,0,1,0,1,0,1,0,1,6,1,0,1,0,1,0,1,0,1,6,1,0,1,0,1,0,1,0,1,6,1,0,1,0,1,0,1,0,8
8,6,6,6,6,6,6,6,6,6,6,6,6,6,6,6,6,6,6,6,6,6,6,6,6,6,6,6,6,6,6,6,6,6,6,6,6,6,6,6,6,6,6,6,6,6,6,6,6,6,6,6,6,6,6,6,6,6,6,6,6,6,6,6,6,6,6,6,6,6,6,6,6,6,6,6,6,6,6,8
8,1,0,1,0,1,0,1,0,1,6,1,0,1,0,1,0,1,0,1,6,1,0,1,0,1,0,1,0,1,6,1,0,1,0,1,0,1,0,1,6,1,0,1,0,1,0,1,0,1,6,1,0,1,0,1,0,1,0,1,6,1,0,1,0,1,0,1,0,1,6,1,0,1,0,1,0,1,0,8
8,0,1,0,1,0,1,0,1,0,6,0,1,0,1,0,1,0,1,0,6,0,1,0,1,0,1,0,1,0,6,0,1,0,1,0,1,0,1,0,6,0,1,0,1,0,1,0,1,0,6,0,1,0,1,0,1,0,1,0,6,0,1,0,1,0,1,0,1,0,6,0,1,0,1,0,1,0,1,8
8,1,0,1,0,1,0,1,0,1,6,1,0,1,0,1,0,1,0,1,6,1,0,1,0,1,0,1,0,1,6,1,0,1,0,1,0,1,0,1,6,1,0,1,0,1,0,1,0,1,6,1,0,1,0,1,0,1,0,1,6,1,0,1,0,1,0,1,0,1,6,1,0,1,0,1,0,1,0,8
8,0,1,0,1,0,1,0,1,0,6,0,1,0,1,0,1,0,1,0,6,0,1,0,1,0,1,0,1,0,6,0,1,0,1,0,1,0,1,0,6,0,1,0,1,0,1,0,1,0,6,0,1,0,1,0,1,0,1,0,6,0,1,0,1,0,1,0,1,0,6,0,1,0,1,0,1,0,1,8
8,1,0,1,0,1,0,1,0,1,6,1,0,1,0,1,0,1,0,1,6,1,0,1,0,1,0,1,0,1,6,1,0,1,0,1,0,1,0,1,6,1,0,1,0,1,0,1,0,1,6,1,0,1,0,1,0,1,0,1,6,1,0,1,0,1,0,1,0,1,6,1,0,1,0,1,0,1,0,8
8,0,1,0,1,0,1,0,1,0,6,0,1,0,1,0,1,0,1,0,6,0,1,0,1,0,1,0,1,0,6,0,1,0,1,0,1,0,1,0,6,0,1,0,1,0,1,0,1,0,6,0,1,0,1,0,1,0,1,0,6,0,1,0,1,0,1,0,1,0,6,0,1,0,1,0,1,0,1,8
8,1,0,1,0,1,0,1,0,1,6,1,0,1,0,1,0,1,0,1,6,1,0,1,0,1,0,1,0,1,6,5,0,5,0,1,0,1,0,1,6,1,0,1,0,1,0,1,0,1,6,1,0,1,0,1,0,7,7,7,6,1,0,1,0,1,0,1,0,1,6,1,0,1,0,1,0,1,0,8
8,0,1,0,1,0,1,0,1,0,6,0,1,0,1,0,1,0,1,0,6,0,1,0,1,0,1,0,1,0,6,0,1,0,1,0,1,0,8,8,6,8,8,0,1,0,1,0,1,0,6,0,1,0,1,0,1,7,7,7,6,0,1,0,1,0,1,0,1,0,6,0,1,0,1,0,1,0,1,8
8,1,0,1,0,1,0,1,0,1,6,1,0,1,0,1,0,1,0,1,6,1,0,1,0,1,0,1,0,1,6,5,0,5,0,1,0,1,8,8,6,8,8,1,0,1,0,1,0,1,6,1,0,1,0,1,0,7,7,7,6,1,0,1,0,1,0,1,0,1,6,1,0,1,0,1,0,1,0,8
8,6,6,6,6,6,6,6,6,6,6,6,6,6,6,6,6,6,6,6,6,6,6,6,6,6,6,6,6,6,6,6,6,6,6,6,6,6,6,6,6,6,6,6,6,6,6,6,6,6,6,6,6,6,6,6,6,6,6,6,6,6,6,6,6,6,6,6,6,6,6,6,6,6,6,6,6,6,6,8
8,1,0,1,0,1,0,1,0,1,6,1,0,1,0,1,0,1,0,1,6,5,5,5,5,5,5,5,5,5,6,1,0,1,0,1,0,1,0,1,6,1,0,1,0,1,0,1,0,1,6,5,5,5,5,5,5,5,5,5,6,1,0,1,0,1,0,1,0,1,6,1,0,1,0,1,0,1,0,8
8,0,1,0,1,0,1,0,1,0,6,0,1,0,1,0,1,0,1,0,6,5,5,5,5,5,5,5,5,5,6,0,1,0,1,0,1,0,1,0,6,0,1,0,1,0,1,0,1,0,6,5,5,5,5,5,5,5,5,5,6,0,1,0,1,0,1,0,1,0,6,0,1,0,1,0,1,0,1,8
8,1,0,1,0,1,0,1,0,1,6,1,0,1,0,1,0,1,0,1,6,5,5,5,5,5,5,5,5,5,6,1,0,1,0,1,0,1,0,1,6,1,0,1,0,1,0,1,0,1,6,5,5,5,5,5,5,5,5,5,6,1,0,1,0,1,0,1,0,1,6,1,0,1,0,1,0,1,0,8
8,0,1,0,1,0,1,0,1,0,6,0,1,0,1,0,1,0,1,0,6,5,5,5,5,5,5,5,5,5,6,0,1,0,1,0,1,0,1,0,6,0,1,0,1,0,1,0,1,0,6,5,5,5,5,5,5,5,5,5,6,0,1,0,1,0,1,0,1,0,6,0,1,0,1,0,1,0,1,8
8,1,0,1,0,1,0,1,0,1,6,1,0,1,0,1,0,1,0,1,6,1,0,1,0,1,0,1,0,1,6,1,0,1,0,1,0,1,0,1,6,1,0,1,0,1,0,1,0,1,6,1,0,1,0,1,0,1,0,1,6,1,0,1,0,1,0,1,0,1,6,1,0,1,0,1,0,1,0,8
8,0,1,0,1,0,1,0,1,0,6,0,1,0,1,0,1,0,1,0,6,0,1,0,1,0,1,0,1,0,6,0,1,0,1,0,1,0,1,0,6,9,9,9,1,0,1,0,1,0,6,0,1,0,1,0,1,0,1,0,6,0,1,0,1,0,1,0,1,0,6,0,1,0,1,0,1,0,1,8
8,1,0,1,0,1,0,1,0,1,6,1,0,1,0,1,0,1,0,1,6,1,0,1,0,1,0,1,0,1,6,1,0,1,0,1,0,1,0,1,6,9,9,9,0,1,0,1,0,1,6,1,0,1,0,1,0,1,0,1,6,1,0,1,0,1,0,1,0,1,6,1,0,1,0,1,0,1,0,8
8,0,1,0,1,0,1,0,1,0,6,0,1,0,1,0,1,0,1,0,6,0,1,0,1,0,1,0,1,0,6,7,7,0,1,0,1,0,1,0,6,9,9,9,1,0,1,0,1,0,6,0,1,0,1,0,1,0,1,0,6,0,1,0,1,0,1,0,1,0,6,0,1,0,1,0,1,0,1,8
8,1,0,1,0,1,0,1,0,1,6,1,0,1,0,1,0,1,0,1,6,1,0,1,0,1,0,1,0,1,6,7,7,1,0,1,0,1,0,1,6,1,0,1,0,1,0,1,0,1,6,1,0,1,0,1,0,1,0,1,6,1,0,1,0,1,0,1,0,1,6,1,0,1,0,1,0,1,0,8
8,6,6,6,6,6,6,6,6,6,6,6,6,6,6,6,6,6,6,6,6,6,6,6,6,6,6,6,6,6,6,6,6,6,6,6,6,6,6,6,6,6,6,6,6,6,6,6,6,6,6,6,6,6,6,6,6,6,6,6,6,6,6,6,6,6,6,6,6,6,6,6,6,6,6,6,6,6,6,8
8,1,0,1,0,1,0,1,0,1,6,1,0,1,0,1,0,1,0,1,6,7,0,1,0,1,0,1,0,1,6,1,0,1,0,1,0,1,0,1,6,1,0,1,0,1,0,1,0,1,6,1,0,1,0,1,0,1,0,1,6,1,0,1,0,1,0,1,0,1,6,1,0,1,0,1,0,1,0,8
8,0,1,0,1,0,1,0,1,0,6,0,1,0,1,0,1,0,1,0,7,7,7,0,1,0,1,0,1,0,6,0,1,0,1,0,1,0,1,0,6,0,1,0,1,0,1,0,1,0,6,0,1,0,1,0,1,0,1,0,6,0,1,0,1,0,1,0,1,0,6,0,1,0,1,0,1,0,1,8
8,1,0,1,0,1,0,1,0,1,6,1,0,1,0,1,0,1,0,7,7,7,7,7,0,1,0,1,0,1,6,1,0,1,0,1,0,1,0,1,6,1,0,1,0,1,0,1,0,1,6,1,0,1,0,1,0,1,0,1,6,1,0,1,0,1,0,1,0,1,6,1,0,1,0,1,0,1,0,8
8,0,1,0,1,0,1,0,1,0,6,0,1,0,1,0,1,0,1,7,7,7,7,7,1,0,1,0,1,0,6,0,1,0,1,0,1,0,1,0,6,0,1,0,1,0,1,0,1,0,6,0,1,0,1,0,1,0,1,0,6,0,1,0,1,0,1,0,1,0,6,0,1,0,1,0,1,0,1,8
8,1,0,1,0,1,0,1,0,1,6,1,0,1,0,1,0,1,0,1,7,7,7,1,0,1,0,1,0,1,6,1,0,1,0,1,0,1,0,1,6,1,0,1,0,1,0,1,0,1,6,1,0,1,0,1,0,1,0,1,6,1,0,1,0,1,0,1,0,1,6,1,0,1,0,1,0,1,0,8
8,0,1,0,1,0,1,0,1,0,6,0,1,0,1,0,1,0,1,0,6,7,1,0,1,0,1,0,1,0,6,0,1,0,1,0,1,0,1,0,6,0,1,0,1,0,1,0,1,0,6,0,1,0,1,0,1,0,1,0,6,0,1,0,1,0,1,0,1,0,6,0,1,0,1,0,1,0,1,8
8,1,0,1,0,1,0,1,0,1,6,1,0,1,0,1,0,1,0,1,6,1,0,1,0,1,0,1,0,1,6,1,0,1,0,1,0,1,0,1,6,1,0,1,0,1,0,1,0,1,6,1,0,1,0,1,0,1,0,1,6,1,0,1,0,1,0,1,0,1,6,1,0,1,0,1,0,1,0,8
8,0,1,0,1,0,1,0,1,0,6,0,1,0,1,0,1,0,1,0,6,0,1,0,1,0,1,0,1,0,6,0,1,0,1,0,1,0,1,0,6,0,1,0,1,0,1,0,1,0,6,0,1,0,1,0,1,0,1,0,6,0,1,0,1,0,1,0,1,0,6,0,1,0,1,0,1,0,1,8
8,1,0,1,0,1,0,1,0,1,6,1,0,1,0,1,0,1,0,1,6,1,0,1,0,1,0,1,0,1,6,1,0,1,0,1,0,1,0,1,6,1,0,1,0,1,0,1,0,1,6,1,0,1,0,1,0,1,0,1,6,1,0,1,0,1,0,1,0,1,6,1,0,1,0,1,0,1,0,8
8,6,6,6,6,6,6,6,6,6,6,6,6,6,6,6,6,6,6,6,6,6,6,6,6,6,6,6,6,6,6,6,6,6,6,6,6,6,6,6,6,6,6,6,6,6,6,6,6,6,6,6,6,6,6,6,6,6,6,6,6,6,6,6,6,6,6,6,6,6,6,6,6,6,6,6,6,6,6,8
8,1,0,1,0,1,0,1,0,1,6,1,0,1,0,1,0,1,0,1,6,1,0,1,0,1,0,1,0,1,6,1,0,1,0,1,0,1,0,1,6,1,0,1,0,1,0,1,0,1,6,1,0,1,0,1,0,1,0,1,6,1,0,1,0,1,0,1,0,1,6,1,0,1,0,1,0,1,0,8
8,0,1,0,1,0,1,0,1,0,6,0,1,0,1,0,1,0,1,0,6,0,1,0,1,0,1,0,1,0,6,0,1,0,1,0,1,0,1,0,6,0,1,0,1,0,1,0,1,0,6,0,1,0,1,0,1,0,1,0,6,0,1,0,1,0,1,0,1,0,6,0,1,0,1,0,1,0,1,8
8,1,0,1,0,1,0,1,0,1,6,1,0,1,0,1,0,1,0,1,6,1,0,1,0,1,0,1,0,1,6,1,0,1,0,1,0,1,0,1,6,1,0,1,0,1,0,1,0,1,6,1,0,1,0,1,0,1,0,1,6,1,0,1,0,1,0,1,0,1,6,1,0,1,0,1,0,1,0,8
8,8,8,8,8,8,8,8,8,8,8,8,8,8,8,8,8,8,8,8,8,8,8,8,8,8,8,8,8,8,8,8,8,8,8,8,8,8,8,8,8,8,8,8,8,8,8,8,8,8,8,8,8,8,8,8,8,8,8,8,8,8,8,8,8,8,8,8,8,8,8,8,8,8,8,8,8,8,8,8
